Acanthocephala	Echinorhynchus_gadi Macracanthorhynchus_hirudinaceus Paratenuisentis_ambiguus Pomphorhynchus_laevis
Annelida	Alvinella_pompejana Capitella_teleta_ours Golfingia_vulgaris_ours Helobdella_sp Lumbricus_rubellus
Arthropoda	Daphnia_pulex_ours Drosophila_melanogaster_ours Solenopsis_invicta Stegodyphus_mimosarum_ours Strigamia_maritima_ours Tribolium_castaneum_ours
Brachiopoda	Glottidia_pyramidata Hemithiris_psittacea Laqueus_californicus Lingula_anatina
Chaetognatha	Eukrohnia_sp Krohnitta_sp Pterosagitta_sp Sagitta_sp Spadella_sp
Chordata	Branchiostoma_floridae_ours Callorhinchus_milii_ours Ciona_intestinalis_ours Homo_sapiens_ours Petromyzon_marinus Salpa_thompsoni
Cnidaria	Alatina_alata Hydra_vulgaris_ours Liriope_tetraphylla Nematostella_vectensis_ours Plumapathes_pennacea
Ctenophora	Coeloplana_meteoris Lampea_pancerina Mnemiopsis_leidyi Vallicula_multiformis 
Cycliophora	Symbion_pandora
Echinodermata	Acanthaster_planci Amphiura_filiformis Florometra_serratisima Litehinus_variegatus Parastichopus_sp Patiria_miniata Strongylocentrotus_purpuratus_ours
Gastrotricha	Dactylopodola_baltica Diuronotus_aspetos Lepidodermella_squamata Macrodasys_sp Megadasys_sp Mesodasys_laticaudatus
Hemichordata	Ptychodera_flava Rhabdopleura_sp Saccoglossus_kowalevskii_ours
Mollusca	Chaetopleura_apiculata Crassostrea_gigas_ours Euprymna_scolopes Leptochiton_rugatus Lottia_gigantea_ours Lymnaea_stagnalis
Nematoda	Caenorhabditis_elegans Enoplus_brevis Plectus_sambesii Romanomermis_culicivoax Trichinella_spiralis
Nemertea	Cephalothrix_linearis Cerebratulus_sp Malacobdella_grossa Paranemertes_peregrina
Platyhelminthes	Microstomum_lineare Moniezia_expansa Monocelis_sp Nematoplana_coelogynoporoides Neobenedenia_melleni Stenostomum__sthenum Stylochoplana_maculata Taenia_solium
Porifera	Amphimedon_queenslandica_ours Leuconia_nivea Plakina_jani Sycon_coactum Sympagella_nux
Priapulida	Priapulus_sp Priapulus_caudatus
Rotifera	Adineta_ricciae Brachionus_manjavacas Brachionus_plicatilis Lecane_inermis Rotaria_rotatoria
Tardigrada	Hypsibius_dujardini Ramazzottius_varieornatus
Xenacoelomorpha	Pseudaphanostoma__variabilis Sterreria_sp Symsagittifera__roscoffensis Xenoturbella_bocki Xenoturbella_profunda
